%%%%%%%
%. P .%
% % % %
%  .  %
% % % %
%. G .%
%%%%%%%
